1111111111111111111111111
1E0000000000000C00000C001
1010010100100000101001001
1010010010101010001001001
1P0000CC00000000000000001
1000000000000000000000001
1000000101001110000C00001
1000CC0101000010000000001
1000000111001110000000001
1000000001001000000000001
10000C0001001110000000001
1000000000000000000000001
1111111111111111111111111
