1111111111111111111111111
1E0000000000000C00000C001
1010010100100000101001001
1010010010101010001001001
1P00000000000000000000001
1P00000000000000000000001
1P00000101001110000000001
1P00000101000010000000001
1P00000111001110000000001
1P00000001001000000000001
1P00000001001110000000001
1P00000000000000000000001
1111111111111111111111111
