111111111111111111111111111111
1P1E00000010000C00000000000001
10000110000000C1C000000001C001
1000000000100C111C000001000001
1000111C100100C1C0000010000111
100000000001000C000001000000C1
100000000000000100000000000001
100000000000000100C00001111111
111111111100011111000001111111
111111111111111111111111111111