111111111111111111111
101000100C10000000001
100C10101P00101000101
101010C01010100010001
10000010101010C010001
10101C000010001000101
100010C0001S001010101
1000100C1010001000101
1C1000100010001010101
1C0010101E10101010001
101010101C10101010101
111111111111111111111