111111111111111111111
101000P000001C0010001
10001000C000101010101
10101010101010C000101
1S0000101010101010001
10100010E000C01000101
1010101010100010001C1
1010001000001C1010001
10001010C000101010101
101010100C10000010001
100010101C10101010101
1010001010001000001C1
10101C101010101010101
111111111111111111111